NO sprites_test/north.xpm
WE sprites_test/west.xpm 
C 0,255,0 
EA sprites_test/east.xpm

R            1023 720


SO sprites_test/south.xpm
F 0,0,0



S sprites_test/sprite.xpm

1111111111111111111111
1000000000000000000001
1011111111111111111101
101                101
101 11111111111111 101
101 10000000000001 101
101 10111111111101 101
101 101        101 101
101 101 111111 101 101
101 101 10N001 101 101
101 101 101111 101 101
101 101 101    101 101
101 101 1011111101 101
101 101 1000000001 101
101 101 1111111111 101
101 101            101
101 101111111111111101
101 100000000000000001
101 111111111111111111
101
1011111111111111111111
1000000000000000000001
1111111111111111111111
