NO text/north.xpm
WE text/west.xpm             
C 255,0,255 
EA  text/east.xpm

R            960 720 


SO text/south.xpm         
F 255,255,255



S text/barrel.xpm



1111111111111111111111111111111111111111111111111111111111
1111111111111111111111111111111111111111111110000000000001
1000000000000000000000000000000000000000001110000000000001
1000000000000000000000000000000000000000001100011111110001
1000000000000000000000000000000000000000001100011100010001
111100011111111111111111111111111111111111100011 100010001
   10001111110001111111111111111111111111110001  100010001
   10000000000001000000000000000000000000000001  100010001
   10001111110001011111111111111111111111111111  100010001
   10001    1000100000000000000000000000011111111100010001
1111000111111000111111111111111111000100000000000000010001
1000000000000000000000000000000000000100000000000000010001
1000000000000000000000000000000000000100000000000000010001
1000000000000000000000000000000000000111111111111111110001
1111111111111111111111111111111000111111111111111111110001
                              1000000000000000000000000001
                              1000000000000000000000000001
                              1000000000000000000000000001
                              1111111111111011111111111111
                             110000000000000000000000000011
                            11000000000000000000000000000011
                           1100000000000200020000000000000011
                          110000000000000000000000000000000011
                         11000000000000000000000000000000000011
                        1100000000000000000N00000000000000000011
                       110000000000000000000000000000000000000011
                      11000000000000000000010000000000000000000011
                      11111111111111111111111111111111111111111111
