NO sprites_test/north.xpm
WE sprites_test/west.xpm
C 0,255,0
EA sprites_test/east.xpm

R            1023 2

NO_SAUCISSE
SO sprites_test/south.xpm
F 0,0,0



S sprites_test/sprite.xpm

1111111111
111111N111
1111111111
11111111111
